s . . o .
p o . p o
. . . . .
o p . o .
. . p . g